45 45 45 45 45 45 45 45 45 45 45 45 45 45 45 45 45 45 45 45 45 45 45 45 45 45 45 45 45 45 45 45 45 45 45 45 45 45 45 45 45 45 45 45 45 45 45 45 45 45 
45 45 45 45 45 45 45 45 45 45 45 45 45 45 45 45 45 45 45 45 45 45 45 45 45 45 45 45 45 45 45 45 45 45 45 45 45 45 45 45 45 45 45 45 45 45 45 45 45 45
45 45 45 45 45 45 45 57 57 45 45 45 45 45 45 45 45 45 45 45 45 45 45 45 45 45 45 45 45 45 45 45 45 45 45 45 45 45 45 45 45 45 45 45 45 45 45 45 45 45
45 45 45 45 45 45 45 57 57 45 45 45 45 45 45 45 45 45 45 45 45 45 45 45 45 45 45 45 45 45 45 45 45 45 45 45 45 45 45 45 45 45 57 45 45 45 45 45 45 45
45 45 45 45 45 45 45 57 45 45 45 45 45 45 45 45 45 45 45 45 45 45 45 45 45 45 45 45 45 45 45 45 45 45 45 45 45 45 45 45 45 45 57 57 45 45 45 45 45 45
45 45 45 45 45 45 45 45 45 45 45 45 45 45 45 45 45 45 45 45 45 45 45 45 45 45 45 45 45 45 45 45 45 45 45 45 45 45 45 45 45 45 45 45 45 45 45 45 45 45
45 45 45 45 45 45 45 45 45 45 45 45 45 45 45 49 48 48 48 48 48 48 48 48 48 48 48 48 48 48 48 48 48 48 48 48 48 70 45 45 45 45 45 45 45 45 45 45 45 45
45 45 45 45 45 45 45 45 45 45 45 45 45 45 45 65 46 46 46 46 46 46 46 46 46 46 46 46 46 46 46 46 46 59 46 46 46 58 45 45 45 45 45 45 45 45 45 45 45 45
45 45 45 45 45 45 45 45 45 45 45 45 45 45 45 65 46 46 46 46 46 46 46 46 46 46 46 46 46 46 46 46 46 46 46 46 46 58 45 45 45 45 45 45 45 45 45 45 45 45
45 45 45 45 45 45 45 45 45 45 45 45 45 45 45 65 46 50 62 62 62 62 62 62 62 62 62 62 62 62 62 62 62 56 46 46 46 58 45 45 45 45 45 45 45 45 45 45 45 45
45 45 45 45 45 45 45 45 45 45 45 45 45 45 45 65 46 64 47 47 47 47 47 47 47 47 47 47 47 47 47 47 47 61 46 46 46 58 45 45 45 45 45 45 45 45 45 45 45 45
45 45 45 45 45 49 48 48 48 48 48 48 48 48 48 46 46 64 47 47 47 47 47 47 47 47 47 47 47 47 47 47 47 61 46 46 46 58 45 45 45 45 45 45 45 45 45 45 45 45
45 45 45 45 45 65 46 46 46 46 46 46 50 62 62 62 62 47 47 47 47 47 47 47 47 47 47 47 47 47 47 47 47 61 46 46 46 46 48 48 48 48 70 45 45 45 45 45 45 45
45 45 45 45 45 65 46 46 46 46 46 50 47 47 47 47 47 47 47 47 47 47 47 47 47 47 47 47 47 47 47 47 47 47 62 62 62 56 46 46 46 46 58 45 45 45 45 45 45 45
45 45 45 45 45 65 46 46 46 46 50 47 47 47 47 47 47 47 47 47 47 47 47 47 47 47 47 47 47 47 47 47 47 47 47 47 47 61 46 46 46 46 58 45 45 45 45 45 45 45
45 45 45 45 45 65 46 46 46 50 47 47 47 47 47 47 47 47 47 47 47 47 66 47 47 47 47 47 47 47 47 47 47 47 47 47 47 61 46 46 46 46 58 45 45 45 45 45 45 45
45 45 45 45 45 65 46 46 46 64 47 47 47 47 47 47 47 47 47 47 47 47 47 47 47 47 47 47 47 47 47 47 47 47 47 47 47 61 46 46 59 46 58 45 45 45 45 45 45 45
45 45 45 45 45 65 46 46 46 64 47 47 47 47 47 47 47 47 47 47 47 47 47 47 47 47 47 47 47 47 47 47 47 47 47 47 47 61 46 46 46 46 58 45 45 45 45 45 45 45
45 45 45 45 45 65 46 46 46 64 47 47 47 47 47 47 47 47 47 47 47 47 47 47 47 47 47 47 47 47 47 66 47 47 47 47 47 61 46 46 46 46 58 45 45 45 45 45 45 45
45 45 45 45 45 65 46 46 46 64 47 47 47 47 47 47 47 47 47 47 47 47 47 47 47 47 47 47 47 47 47 47 47 47 47 47 47 61 46 46 46 46 51 45 45 45 45 45 45 45
45 45 45 45 45 65 46 46 59 64 47 47 47 47 47 47 47 47 47 47 47 47 47 47 47 47 47 47 47 47 47 47 47 47 47 47 47 61 46 46 46 51 45 45 45 45 45 45 45 45
45 45 45 45 45 65 46 46 46 64 47 47 47 47 47 47 47 47 47 47 47 47 47 47 47 47 47 47 47 47 47 47 47 47 47 47 47 61 46 46 58 45 45 45 45 45 45 45 45 45
45 45 45 45 45 65 46 46 46 53 47 47 47 47 47 47 47 47 47 47 47 47 47 47 47 47 47 47 47 47 47 47 47 47 47 47 47 61 46 46 58 45 45 45 45 45 45 45 45 45
45 57 57 45 45 65 46 46 46 46 53 47 47 47 47 47 47 47 47 47 47 47 47 66 47 47 47 47 47 47 47 47 47 47 47 47 47 61 46 46 46 70 45 45 45 45 45 45 45 45
45 45 57 45 45 54 67 46 46 46 46 53 60 60 47 47 47 47 47 47 47 47 47 47 47 47 47 47 47 47 47 47 47 47 47 47 47 61 46 46 46 46 70 45 45 45 45 45 45 45
45 45 45 45 45 45 45 65 46 46 46 46 46 46 64 47 47 47 47 47 47 47 47 47 47 47 47 47 47 47 47 47 47 47 47 60 60 52 46 46 46 46 58 45 45 45 45 45 45 45
45 45 45 45 45 45 45 65 46 46 46 46 46 46 64 47 47 47 47 47 47 47 47 47 47 47 47 47 47 47 47 47 47 47 61 46 46 46 46 46 46 46 58 45 45 45 45 45 45 45
45 45 45 45 45 45 45 65 46 46 46 46 46 46 64 47 47 47 47 47 47 47 47 47 47 47 47 47 47 47 47 47 47 47 61 46 46 46 46 46 46 46 51 45 45 45 45 45 45 45
45 45 45 45 45 45 45 65 46 46 46 46 46 46 64 47 47 47 47 47 47 47 47 47 47 47 47 47 47 47 47 47 47 47 61 46 46 63 46 46 46 55 45 45 45 45 45 45 45 45
45 45 45 45 45 45 45 65 46 46 46 46 46 46 64 47 47 47 47 47 47 47 47 47 47 47 47 47 47 47 47 47 47 47 61 46 58 45 54 63 55 45 45 45 45 45 45 45 45 45
45 45 45 45 45 45 45 65 46 46 46 46 46 46 64 47 47 47 47 47 47 47 47 47 47 47 47 47 47 47 47 47 47 47 61 46 58 45 45 45 45 45 45 45 45 45 45 45 45 45 
45 45 45 45 45 45 45 65 46 46 46 46 46 46 64 47 47 47 47 47 47 47 47 47 47 47 47 47 47 47 47 47 47 47 61 46 58 45 45 45 45 45 45 45 45 45 45 45 45 45 
45 45 45 45 45 45 45 54 63 63 63 63 63 46 64 47 47 47 47 47 47 47 47 47 47 47 47 47 47 47 47 47 47 47 61 46 58 45 45 45 45 45 45 45 45 45 45 45 45 45 
45 45 45 45 45 45 45 45 45 45 45 45 45 65 53 60 47 47 47 47 47 47 47 47 47 47 47 47 47 47 47 47 47 60 52 46 58 45 45 45 45 45 45 45 45 45 45 45 45 45 
45 45 45 45 45 45 45 45 45 45 45 45 45 65 46 46 64 47 47 47 47 47 47 47 47 47 47 47 47 47 47 47 61 46 46 46 58 45 45 45 45 45 45 45 45 45 45 45 45 45
45 45 45 45 45 45 45 45 45 45 45 45 45 65 46 46 64 47 47 47 47 47 47 47 47 47 47 47 47 47 47 47 61 46 46 46 58 45 45 45 45 45 45 45 45 45 45 45 45 45
45 45 45 45 45 45 45 45 45 45 45 45 45 65 46 46 64 47 47 47 47 47 47 47 47 47 47 47 47 47 47 47 61 46 46 46 58 45 45 45 45 45 45 45 45 45 45 45 45 45
45 45 45 45 45 45 45 45 45 45 45 45 45 65 46 46 64 47 47 47 47 47 47 47 47 47 47 47 47 47 47 47 52 46 46 46 58 45 45 45 45 45 45 45 45 45 45 45 45 45
45 45 45 45 45 45 45 45 45 45 45 45 45 65 46 46 64 47 47 47 47 47 47 47 47 47 47 47 47 47 47 52 46 63 63 63 51 45 45 45 45 45 45 45 45 45 45 45 45 45
45 45 45 45 45 45 45 45 45 45 45 45 45 65 46 46 53 60 60 47 47 47 47 47 47 47 47 47 60 60 52 46 58 45 45 45 45 45 45 45 45 45 45 45 45 45 45 45 45 45
45 45 45 45 45 45 45 45 45 45 45 45 45 65 46 46 46 46 46 64 47 47 47 47 47 47 47 61 46 46 46 46 58 45 45 45 45 45 45 45 45 45 45 45 45 45 45 45 45 45
45 45 45 45 45 45 45 45 45 45 45 45 45 54 63 63 63 46 46 64 47 47 47 47 47 47 47 61 46 46 46 46 58 45 45 45 45 45 45 45 45 45 45 45 45 45 45 45 45 45
45 45 45 45 45 45 45 45 45 45 45 45 45 45 45 45 45 65 46 64 47 47 47 47 47 47 47 61 46 46 46 46 58 45 45 45 45 45 45 45 45 45 45 45 45 45 45 45 45 45
45 45 45 45 45 45 45 45 45 45 45 45 45 45 45 45 45 65 46 64 47 47 47 47 47 47 47 61 46 46 46 46 58 45 45 45 45 45 45 45 45 45 45 45 45 45 45 45 45 45
45 45 45 45 45 45 45 45 45 45 45 45 45 45 45 45 45 65 46 64 47 47 47 47 47 47 47 61 46 46 46 46 58 45 45 45 45 45 45 45 45 45 45 45 45 45 45 45 45 45
45 45 45 45 45 45 45 45 45 45 45 45 45 45 45 45 45 65 46 64 47 47 47 47 47 47 47 61 46 46 46 46 58 45 45 45 45 45 45 45 45 45 45 45 45 45 45 45 45 45
45 45 45 45 45 45 45 45 45 45 45 45 45 45 45 45 45 65 46 64 47 47 47 47 47 47 47 61 46 46 46 46 58 45 45 45 45 45 45 45 45 45 45 45 45 45 45 45 45 45
45 45 45 45 45 45 45 45 45 45 45 45 45 45 45 45 45 65 46 64 47 47 47 47 47 47 47 61 46 46 46 46 58 45 45 45 45 45 45 45 45 45 45 45 45 45 45 45 45 45
45 45 45 45 45 45 45 45 45 45 45 45 45 45 45 45 45 65 46 53 60 60 60 60 60 60 60 52 46 46 46 46 58 45 45 45 45 45 45 45 45 45 45 45 45 45 45 45 45 45
45 45 45 45 45 45 45 45 45 45 45 45 45 45 45 45 45 65 46 46 46 46 46 46 46 46 46 46 46 46 46 46 58 45 45 45 45 45 45 45 45 45 45 45 45 45 45 45 45 45